10
8
42 24 24 24 0 0 24 24 24 43 
39 2 2 2 2 2 2 2 2 40 
39 2 2 2 2 2 2 1 2 40 
9 2 1 2 2 2 2 2 2 10 
9 2 2 2 2 2 2 2 2 10 
39 2 2 2 2 1 2 2 2 40 
39 2 2 2 2 2 2 2 2 40 
44 41 41 41 11 11 41 41 41 45 
