10
8
42 24 24 24 12 13 24 24 24 43 
39 2 2 2 2 2 2 2 2 40 
39 2 2 1 2 2 2 5 2 40 
39 2 2 2 2 2 2 2 2 14 
39 2 2 2 3 2 2 2 2 15 
39 2 5 2 2 2 2 5 2 40 
39 2 2 2 2 2 2 2 2 40 
44 41 41 41 41 41 41 41 41 45 
