10
8
51 33 33 40 24 25 40 33 33 52 
48 2 3 3 3 3 3 3 4 49 
48 0 12 13 13 13 13 14 1 49 
48 0 10 8 8 8 8 11 1 49 
48 0 10 8 8 8 8 11 1 49 
48 0 15 16 16 16 16 17 1 49 
48 5 6 6 6 6 6 6 7 49 
53 50 50 50 30 31 50 50 50 54 
