10
8
42 29 24 31 24 24 31 24 29 43 
39 2 2 2 2 2 2 2 2 40 
39 2 2 2 2 2 2 1 2 40 
39 2 2 2 2 2 2 2 2 40 
39 2 2 2 2 2 2 2 2 40 
39 2 2 1 2 2 2 2 2 40 
39 2 2 2 2 2 2 2 2 40 
44 41 41 41 18 19 41 41 41 45 
