10
8
42 24 24 24 24 24 24 24 24 43 
39 3 5 2 2 2 2 5 3 40 
39 5 2 4 1 1 4 2 5 40 
39 2 2 1 2 2 1 2 2 40 
39 2 2 1 2 2 1 2 2 40 
39 5 2 4 1 1 4 2 5 40 
39 3 5 2 2 2 2 5 3 40 
44 41 41 41 18 19 41 41 41 45 
