10
8
51 33 33 33 33 33 33 33 33 52 
48 2 3 3 3 3 3 3 4 49 
48 0 9 9 9 9 9 9 1 49 
48 0 9 9 12 14 9 9 1 26 
48 0 9 9 15 17 9 9 1 27 
48 0 9 9 9 9 9 9 1 49 
48 5 6 6 6 6 6 6 7 49 
53 50 50 50 30 31 50 50 50 54 
