10
8
42 24 24 24 12 13 24 24 24 43 
39 2 2 2 2 2 2 2 2 40 
39 2 2 2 2 2 2 2 2 40 
16 2 1 2 2 2 2 2 2 14 
17 2 2 2 2 2 2 2 2 15 
39 2 2 2 2 1 2 2 2 40 
39 2 2 2 2 2 2 2 2 40 
44 41 41 41 18 19 41 41 41 45 
