10
8
42 24 24 31 12 13 31 24 24 43 
39 2 2 2 2 2 2 1 2 40 
39 2 3 2 2 2 2 2 2 40 
16 2 2 2 2 2 2 2 1 40 
17 2 2 2 2 3 2 2 2 40 
39 2 2 4 2 2 2 5 2 40 
39 2 2 2 2 2 2 2 2 40 
44 41 41 41 41 41 41 41 41 45 
