10
8
51 33 33 33 24 25 33 33 33 52 
48 2 3 3 3 3 3 3 4 49 
48 23 12 13 13 14 9 22 1 49 
48 23 10 8 8 20 14 9 1 49 
48 23 15 16 18 8 20 14 1 49 
48 23 9 9 15 16 16 17 1 49 
48 5 6 6 6 6 6 6 7 49 
53 50 50 50 50 50 50 50 50 54 
